R 50000 50000
NO ./textures/redbrick.xpm
WE ./textures/colorstone.xpm
EA ./textures/mossy.xpm
SO ./textures/bluestone.xpm
S ./textures/barrel.xpm
F 169,69,19
C 135,206,235

        1111111111111111111111111
        1000000000000000000000001
        1011000000000000002000001
        1001000000200000000200001
111111111011020000000000002000001
100022000011002001000111111111111
11110111111111011120000020001
11110111111111011101010010001
11200020110101011100000010201
10002000200000001100000010201
10000200020002001101010010201
11220001110101011111011110101
11110111 1110101 1011110100N1
11111111 1111111 111111111111
